XXXXXXXXXXXXXXXXXXXXXXXXXXXXX
X                           X
X                           X
XU    XX         XX         X
XX                        MTX
X   X                    XXXX
X       X                   X
X              X            X
X                   M     M X
X                  XXXXXXXXXX
X         M  M     X
X        XXXXXX    X
X                  X
XP                 X
XXXXXXXXXXXXXXXXXXXX