XXXXXXXXXXXXXXXXXXXX
X                  X
X   U     M T      X
X        XXXXX     X
X       M          X
X     XXXXX        X
X                  X
X P                X
XXXXXXXXXXXXXXXXXXXX