XXXXXXXXXXXXXXXXXXXXXXXXXXXXX
X                           X
X                      X  M X
XU     X               X XXXX
XX               X     X    X
X   X                  X M  X
X       X              XXXX X
X           X          X    X
X               X      X  MTX
X                  XXXXXXXXXX
X         M  M     X         
X        XXXXXX    X         
X                  X         
XP                 X         
XXXXXXXXXXXXXXXXXXXX         