XXXXXXXXXXXXXXXXXXXX
X   U              X
X                 TX
X         M     XXXX
X        XXXX      X
X       M          X
X     XXXXX        X
X                  X
X P                X
XXXXXXXXXXXXXXXXXXXX